#tileset underground
BACKGROUND_COLOR 0 0 0
00 00 00 00 00 00 00 00  00 00 00 00 00 00 00 00 00 00 00 00 00 00 00 00 00 00 00
00 00 00 00 00 00 00 00  00 00 00 00 00 00 00 00 00 00 00 00 00 00 00 00 00 00 00
38 38 38 38 38 38 00 00M 00 38 38 38 38 38 38 38 00 00 00 00 23 27 38 38 38 38 38
38 38 38 38 38 38 00 00  00 00 00 00 00 00 00 00 00 00 00 00 23 27 38 38 38 38 38
38 38 38 38 38 38 00 00  00 00 00 00 00 00 00 00 00 00 00 00 23 27 38 38 38 38 38
38 38 38 38 38 38 00 00  00 00 00 00 00 00 00 00 00 00 00 00 23 27 38 38 38 38 38
38 38 38 38 38 38 00 00  00 00 00 00 00 00 00 00 00 00 00 00 23 27 38 38 38 38 38
38 38 38 38 38 38 00 00  00 00 00 00 00 00 00 00 00 00 00 00 23 27 38 38 38 38 38
38 38 38 38 38 38 00 00  00 00 00 00 00 00 00 00 00 00 00 00 23 27 38 38 38 38 38
38 38 38 38 38 38 00 00  00 00 00 00 00 00 00 00 00 00 00 00 23 27 38 38 38 38 38
38 38 38 38 38 38 00 00  00 38 38 38 38 38 38 38 00 00 00 00 23 27 38 38 38 38 38
38 38 38 38 38 38 00 00  00 38 38 38 38 38 38 38 00 00 20 21 22 27 38 38 38 38 38
38 38 38 38 38 38 00 00  00 38 38 38 38 38 38 38 00 00 24 25 26 27 38 38 38 38 38
01 01 01 01 01 01 01 01  01 01 01 01 01 01 01 01 01 01 01 01 01 01 01 01 01 01 01
01 01 01 01 01 01 01 01  01 01 01 01 01 01 01 01 01 01 01 01 01 01 01 01 01 01 01