#tileset overworld
BACKGROUND_COLOR 92 148 252
00 00 00 00 00 00 00 00 00 00 00 00 00 00 00 00 00 00 00 00 00 00 00 00 00 00 00 00 00 00 00 00 00 00 00 00 00 00 00 00 00 00 00 00 00 00 00 00 00 00 00 00 00 00 00 00 00 00 00 00 00 00 00 00 00 00 00 00 00 00 00 00 00 00 00 00 00 00 00 00 00 00 00 00 00 00 00 00 00 00 00 00 00 00 00 00 00 00 00 00 00 00 00 00 00 00 00 00 00 00 00 00 00 00 00 00 00 00 00 00 00 00 00 00 00 00 00 00 00 00 00 00 00 00 00 00 00 00 00 00 00 00 00 00 00 00 00 00 00 00 00 00 00 00 00 00 00 00 00 00 00 00 00 00 00 00 00 00 00 00 00 00 00 00 00 00 00 00 00 00 00 00 00 00 00 00 00 00 00 00 00 00 00 00 00 00 00 00 00 00 00 00 00 00 00 00 00 00 00 00 00 00
00 00 00 00 00 00 00 00 00 00 00 00 00 00 00 00 00 00 00 00 00 00 00 00 00 00 00 00 00 00 00 00 00 00 00 00 00 00 00 00 00 00 00 00 00 00 00 00 00 00 00 00 00 00 00 00 00 00 00 00 00 00 00 00 00 00 00 00 00 00 00 00 00 00 00 00 00 00 00 00 00 00 00 00 00 00 00 00 00 00 00 00 00 00 00 00 00 00 00 00 00 00 00 00 00 00 00 00 00 00 00 00 00 00 00 00 00 00 00 00 00 00 00 00 00 00 00 00 00 00 00 00 00 00 00 00 00 00 00 00 00 00 00 00 00 00 00 00 00 00 00 00 00 00 00 00 00 00 00 00 00 00 00 00 00 00 00 00 00 00 00 00 00 00 00 00 00 00 00 00 00 00 00 00 00 00 00 00 00 00 00 00 00 00 00 00 00 00 00 00 00 00 00 00 00 00 00 00 00 00 00 00
00 00 00 00 00 00 00 00 00 00 00 00 00 00 00 00 00 00 00 68 69 70 00 00 00 00 00 00 00 00 00 00 00 00 00 00 68 69 69 70 00 00 00 00 00 00 00 00 00 00 00 00 00 00 00 00 00 00 00 00 00 00 00 00 00 00 00 68 69 70 00 00 00 00 00 00 00 00 00 00 00 00 00 00 68 69 69 70 00 00 00 00 00 00 00 00 00 00 00 00 00 00 00 00 00 00 00 00 00 00 00 00 00 00 00 68 69 70 00 00 00 00 00 00 00 00 00 00 00 00 00 00 00 00 68 69 69 70 00 00 00 00 00 00 00 00 00 00 00 00 00 00 00 00 00 00 00 00 00 00 00 00 00 68 69 70 00 00 00 00 00 00 00 00 00 00 00 00 00 00 68 69 69 70 00 00 00 00 00 00 00 00 00 00 00 00 00 00 51 00 00 00 00 00 00 00 00 00 00 00 00 00
00 00 00 00 00 00 00 00 68 69 70 00 00 00 00 00 00 00 00 71 72 73 00 00 00 00 00 68 69 69 69 70 00 00 00 00 71 72 72 73 00 00 00 00 00 00 00 00 00 00 00 00 00 00 00 00 68 69 70 00 00 00 00 00 00 00 00 71 72 73 00 00 00 00 00 68 69 69 69 70 00 00 00 00 71 72 72 73 00 00 00 00 00 00 00 00 00 00 00 00 00 00 00 00 68 69 70 00 00 00 00 00 00 00 00 71 72 73 00 00 00 00 00 68 69 69 69 70 00 00 00 00 00 00 71 72 72 73 00 00 00 00 00 00 00 00 00 00 00 00 00 00 68 69 70 00 00 00 00 00 00 00 00 71 72 73 00 00 00 00 00 68 69 69 69 70 00 00 00 00 71 72 72 73 00 00 00 00 00 00 00 00 00 00 00 00 00 00 55 00 00 68 69 70 00 00 00 00 00 00 00 00
00 00 00 00 00 00 00 00 71 72 73 00 00 00 00 00 00 00 00 00 00 00 00 00 00 00 00 71 72 72 72 73 00 00 00 00 00 00 00 00 00 00 00 00 00 00 00 00 00 00 00 00 00 00 00 00 71 72 73 00 00 00 00 00 00 00 00 00 00 00 00 00 00 00 00 71 72 72 72 73 00 00 00 00 00 00 00 00 00 00 00 00 00 00 00 00 00 00 00 00 00 00 00 00 71 72 73 00 00 00 00 00 00 00 00 00 00 00 00 00 00 00 00 71 72 72 72 73 00 00 00 00 00 00 00 00 00 00 00 00 00 00 00 00 00 00 00 00 00 00 00 00 71 72 73 00 00 00 00 00 00 00 00 00 00 00 00 00 00 00 00 71 72 72 72 73 00 00 00 00 00 00 00 00 00 00 00 00 00 00 00 00 00 00 00 00 00 00 55 00 00 71 72 73 00 00 00 00 00 00 00 00
00 00 00 00 00 00 00 00 00 00 00 00 00 00 00 00 00 00 00 00 00 00 02 00 00 00 00 00 00 00 00 00 00 00 00 00 00 00 00 00 00 00 00 00 00 00 00 00 00 00 00 00 00 00 00 00 00 00 00 00 00 00 00 00 00 00 00 00 00 00 00 00 00 00 00 00 00 00 00 00 02 02 02 02 02 02 02 02 00 00 00 02 02 02 02 00 00 00 00 00 00 00 00 00 00 00 00 00 00 02 00 00 00 00 00 00 00 00 00 00 00 02 02 02 00 00 00 00 02 02 02 02 00 00 00 00 00 00 00 00 00 00 00 00 00 00 00 00 00 00 00 00 00 00 00 00 00 00 00 00 00 00 00 00 00 00 00 00 00 00 00 00 00 00 00 00 00 00 00 00 00 00 00 00 00 00 00 00 02 02 00 00 00 00 00 00 00 00 55 00 00 00 00 00 00 00 00 00 00 00 00 00
00 00 00 00 00 00 00 00 00 00 00 00 00 00 00 00 00 00 00 00 00 00 00 00 00 00 00 00 00 00 00 00 00 00 00 00 00 00 00 00 00 00 00 00 00 00 00 00 00 00 00 00 00 00 00 00 00 00 00 00 00 00 00 00 00 00 00 00 00 00 00 00 00 00 00 00 00 00 00 00 00 00 00 00 00 00 00 00 00 00 00 00 00 00 00 00 00 00 00 00 00 00 00 00 00 00 00 00 00 00 00 00 00 00 00 00 00 00 00 00 00 00 00 00 00 00 00 00 00 00 00 00 00 00 00 00 00 00 00 00 00 00 00 00 00 00 00 00 00 00 00 00 00 00 00 00 00 00 00 00 00 00 00 00 00 00 00 00 00 00 00 00 00 00 00 00 00 00 00 00 00 00 00 00 00 00 00 02 02 02 00 00 00 00 00 00 00 00 55 00 00 00 00 00 00 00 00 00 00 00 00 00
00 00 00 00 00 00 00 00 00 00 00 00 00 00 00 00 00 00 00 00 00 00 00 00 00 00 00 00 00 00 00 00 00 00 00 00 00 00 00 00 00 00 00 00 00 00 00 00 00 00 00 00 00 00 00 00 00 00 00 00 00 00 00 00 00 00 00 00 00 00 00 00 00 00 00 00 00 00 00 00 00 00 00 00 00 00 00 00 00 00 00 00 00 00 00 00 00 00 00 00 00 00 00 00 00 00 00 00 00 00 00 00 00 00 00 00 00 00 00 00 00 00 00 00 00 00 00 00 00 00 00 00 00 00 00 00 00 00 00 00 00 00 00 00 00 00 00 00 00 00 00 00 00 00 00 00 00 00 00 00 00 00 00 00 00 00 00 00 00 00 00 00 00 00 00 00 00 00 00 00 00 00 00 00 00 00 02 02 02 02 00 00 00 00 00 00 00 00 55 00 00 00 00 00 00 00 00 00 00 00 00 00
00 00 00 00 00 00 00 00 00 00 00 00 00 00 00 00 00 00 00 00 00 00 00 00 00 00 00 00 00 00 00 00 00 00 00 00 00 00 00 00 00 00 00 00 00 00 00 00 00 00 00 00 00 00 00 00 00 00 00 00 00 00 00 00 00 00 00 00 00 00 00 00 00 00 00 00 00 00 00 00 00 00 00 00 00 00 00 00 00 00 00 00 00 00 00 00 00 00 00 00 00 00 00 00 00 00 00 00 00 00 00 00 00 00 00 00 00 00 00 00 00 00 00 00 00 00 00 00 00 00 00 00 00 00 00 00 00 00 00 00 00 00 00 00 00 00 00 00 00 00 00 00 00 00 00 00 00 00 00 00 00 00 00 00 00 00 00 00 00 00 00 00 00 00 00 00 00 00 00 00 00 00 00 00 00 02 02 02 02 02 00 00 00 00 00 00 00 00 55 00 00 00 00 35 35 35 00 00 00 00 00 00
00 00 00 00 00 00 00 00 00 00 00 00 00 00 00 00 02 00 00 00 02 02 02 02 02 00 00 00 00 00 00 00 00 00 00 00 00 00 00 00 00 00 00 00 00 00 19 18 00 00 00 00 00 00 00 00 00 19 18 00 00 00 00 00 00 00 00 00 00 00 00 00 00 00 00 00 00 02 02 02 00 00 00 00 00 00 00 00 00 00 00 00 00 00 02 00 00 00 00 00 02 02 00 00 00 00 02 00 00 02 00 00 02 00 00 00 00 00 02 00 00 00 00 00 00 00 00 00 00 02 02 00 00 00 00 00 00 02 00 00 02 00 00 00 00 00 00 00 00 00 00 02 02 00 00 02 00 00 00 00 00 00 00 00 00 00 00 00 02 02 02 02 00 00 00 00 00 00 00 00 00 00 00 00 02 02 02 02 02 02 00 00 00 00 00 00 00 00 55 00 00 00 00 37 38 39 00 00 00 00 00 00
00 00 47 00 00 00 00 00 00 00 00 00 00 00 00 00 00 00 00 00 00 00 00 00 00 00 00 00 00 00 00 00 00 00 00 00 00 00 19 18 00 00 00 00 00 00 23 27 00 00 47 00 00 00 00 00 00 23 27 00 00 00 00 00 00 00 00 00 00 00 00 00 00 00 00 00 00 00 00 00 00 00 00 00 00 00 00 00 00 00 00 00 00 00 00 00 00 00 47 00 00 00 00 00 00 00 00 00 00 00 00 00 00 00 00 00 00 00 00 00 00 00 00 00 00 00 00 00 00 00 00 00 00 00 00 00 02 02 00 00 02 02 00 00 00 00 47 00 00 00 02 02 02 00 00 02 02 00 00 00 00 00 00 00 00 00 00 00 00 00 00 00 00 00 00 00 00 00 00 00 00 00 00 02 02 02 02 02 02 02 00 00 00 00 47 00 00 00 55 00 00 00 35 33 33 33 35 00 00 00 00 00
00 48 44 49 00 00 00 00 00 00 00 00 00 00 00 00 00 47 00 00 00 00 00 00 00 00 00 00 19 18 00 00 00 00 00 00 00 00 23 27 00 00 00 00 00 00 23 27 00 48 44 49 00 00 00 00 00 23 27 00 00 00 00 00 00 47 00 00 00 00 00 00 00 00 00 00 00 00 00 00 00 00 00 00 00 00 00 00 00 00 00 00 00 00 00 00 00 48 44 49 00 00 00 00 00 00 00 00 00 00 00 00 00 47 00 00 00 00 00 00 00 00 00 00 00 00 00 00 00 00 00 00 00 00 00 02 02 02 00 00 02 02 02 00 00 48 44 49 00 02 02 02 02 00 00 02 02 02 00 00 00 47 00 19 18 00 00 00 00 00 00 00 00 00 00 00 00 00 00 19 18 00 02 02 02 02 02 02 02 02 00 00 00 48 44 49 00 00 55 00 00 00 38 38 40 38 38 00 00 47 00 00
48 44 45 46 49 00 00 00 00 00 00 64 65 65 65 66 48 44 49 00 00 00 00 64 65 66 00 00 23 27 00 00 00 00 00 00 00 00 23 27 00 64 65 65 66 00 23 27 48 44 45 46 49 00 00 00 00 23 27 64 65 65 65 66 48 44 49 00 00 00 00 64 65 66 00 00 00 00 00 00 00 00 00 00 00 00 00 00 00 64 65 65 66 00 00 00 48 44 45 46 49 00 00 00 00 00 00 64 65 65 65 66 48 44 49 00 00 00 00 64 65 66 00 00 00 00 00 00 00 00 00 00 00 00 02 02 02 02 65 65 02 02 02 02 48 44 45 46 02 02 02 02 02 00 00 02 02 02 02 66 48 44 49 23 27 00 00 64 65 66 00 00 00 00 00 00 00 00 00 23 27 02 02 02 02 02 02 02 02 02 00 00 48 44 45 46 49 00 02 00 00 00 38 38 41 38 38 66 48 44 49 00
01 01 01 01 01 01 01 01 01 01 01 01 01 01 01 01 01 01 01 01 01 01 01 01 01 01 01 01 01 01 01 01 01 01 01 01 01 01 01 01 01 01 01 01 01 01 01 01 01 01 01 01 01 01 01 01 01 01 01 01 01 01 01 01 01 01 01 01 01 00 00 01 01 01 01 01 01 01 01 01 01 01 01 01 01 01 00 00 00 01 01 01 01 01 01 01 01 01 01 01 01 01 01 01 01 01 01 01 01 01 01 01 01 01 01 01 01 01 01 01 01 01 01 01 01 01 01 01 01 01 01 01 01 01 01 01 01 01 01 01 01 01 01 01 01 01 01 01 01 01 01 01 01 00 00 01 01 01 01 01 01 01 01 01 01 01 01 01 01 01 01 01 01 01 01 01 01 01 01 01 01 01 01 01 01 01 01 01 01 01 01 01 01 01 01 01 01 01 01 01 01 01 01 01 01 01 01 01 01 01 01 01
01 01 01 01 01 01 01 01 01 01 01 01 01 01 01 01 01 01 01 01 01 01 01 01 01 01 01 01 01 01 01 01 01 01 01 01 01 01 01 01 01 01 01 01 01 01 01 01 01 01 01 01 01 01 01 01 01 01 01 01 01 01 01 01 01 01 01 01 01 00 00 01 01 01 01 01 01 01 01 01 01 01 01 01 01 01 00 00 00 01 01 01 01 01 01 01 01 01 01 01 01 01 01 01 01 01 01 01 01 01 01 01 01 01 01 01 01 01 01 01 01 01 01 01 01 01 01 01 01 01 01 01 01 01 01 01 01 01 01 01 01 01 01 01 01 01 01 01 01 01 01 01 01 00 00 01 01 01 01 01 01 01 01 01 01 01 01 01 01 01 01 01 01 01 01 01 01 01 01 01 01 01 01 01 01 01 01 01 01 01 01 01 01 01 01 01 01 01 01 01 01 01 01 01 01 01 01 01 01 01 01 01
