00000000000000000000000000000000000000000000000000000000000000000000000000000000000000000000000000000000000000000000000000000000000000000000000000000000000000000000000000000000000000000000000000000000000000000000
00000000000000000000000000000000000000000000000000000000000000000000000000000000000000000000000000000000000000000000000000000000000000000000000000000000000000000000000000000000000000000000000000000000000000000000
00000000000000000000000000000000000000000000000000000000000000000000000000000000000000000000000000000000000000000000000000000000000000000000000000000000000000000000000000000000000000000000000000000000000000000000
00000000000000000000000000000000000000000000000000000000000000000000000000000000000000000000000000000000000000000000000000000000000000000000000000000000000000000000000000000000000000000000000000000000000000000000
00000000000000000000000000000000000000000000000000000000000000000000000000000000000000000000000000000000000000000000000000000000000000000000000000000000000000000000000000000000000000000000000000000000000000000000
00000000000000000000010000000000000000000000000000000000000000000000000000000000111111110001111000000000000001000000000001110000111100000000000000000000000000000000000000000000000000000000022000000000000000000000
00000000000000000000000000000000000000000000000000000000000000000000000000000000000000000000000000000000000000000000000000000000000000000000000000000000000000000000000000000000000000000000222000000000000000000000
00000000000000000000000000000000000000000000000000000000000000000000000000000000000000000000000000000000000000000000000000000000000000000000000000000000000000000000000000000000000000000002222000000000000000000000
00000000000000000000000000000000000000000000000000000000000000000000000000000000000000000000000000000000000000000000000000000000000000000000000000000000000000000000000000000000000000000022222000000000000000000000
00000000000000010001111100000000000000000000011000000000110000000000000000000111000000000000001000001100001001001000001000000000011000000020020000000000220020000000000001111000000000000222222000000000000000000000
00000000000000000000000000000000000001100000011000000000110000000000000000000000000000000000000000000000000000000000000000000000000000000220022000000002220022000000000000000000000000002222222000000000000000000000
00000000000000000000000000011000000001100000011000000000110000000000000000000000000000000000000000000000000000000000000000000000000000002220022200000022220022200000110000000000000011022222222000000000000000000000
00000000m00000000000000000011000000001100000011000000000110000000000000000000000000000000000000000000000000000000000000000000000000000022220022220000222220022220000110000000000000011222222222000000002000000000000
11111111111111111111111111111111111111111111111111111111111111111111100111111111111111000111111111111111111111111111111111111111111111111111111111111111110011111111111111111111111111111111111111111111111111111111
11111111111111111111111111111111111111111111111111111111111111111111100111111111111111000111111111111111111111111111111111111111111111111111111111111111110011111111111111111111111111111111111111111111111111111111