....................................................................................................................................................................................................................
....................................................................................................................................................................................................................
....................................................................................................................................................................................................................
....................................................................................................................................................................................................................
....................................................................................................................................................................................................................
.....................#..........................................................########...####..............#...........###....####.........................................................##.....................
............................................................................................................................................................................................###.....................
...........................................................................................................................................................................................####.....................
..........................................................................................................................................................................................#####.....................
...............#...#####.....................##.........##...................###..............#.....##....#..#..#.....#..........##.......#..#..........##..#............####............######.....................
.....................................##......##.........##...............................................................................##..##........###..##..........................#######.....................
...........................##........##......##.........##..............................................................................###..###......####..###.....##..............##.########.....................
...m.......................##........##......##.........##.............................................................................####..####....#####..####....##..............###########........#............
#####################################################################..###############...#################################################################..########################################################
#####################################################################..###############...#################################################################..########################################################