#tileset overworld
BACKGROUND_COLOR 92 148 252
00 00 00 00 00 00 00 00 00 00 00 00 00 00 00 00 00 00 00 00 00 00 00 00 00 00 00 00 00 00 00 00
00 00 00 00 00 00 00 00 00 00 00 00 00 00 00 00 00 00 00 00 00 00 00 00 00 00 00 00 00 00 00 00
00 00 00 00 00 00 00 00 00 00 00 00 00 00 00 00 00 00 00 68 69 70 00 00 00 00 00 00 00 00 00 00
00 00 00 00 00 00 00 00 68 69 70 00 00 00 00 00 00 00 00 71 72 73 00 00 00 00 00 68 69 69 69 70
00 00 00 00 00 00 00 00 71 72 73 00 00 00 00 00 00 00 00 00 00 00 00 00 00 00 00 71 72 72 72 73
00 00 00 00 00 00 00 00 00 00 00 00 00 00 00 00 00 00 00 00 00 00 02 00 00 00 00 00 00 00 00 00
00 00 00 00 00 00 00 00 00 00 00 00 00 00 00 00 00 00 00 00 00 00 00 00 00 00 00 00 00 00 00 00
00 00 00 00 00 00 00 00 00 00 00 00 00 00 00 00 00 00 00 00 00 00 00 00 00 00 00 00 00 00 00 00
00 00 00 00 00 00 00 00 00 00 00 00 00 00 00 00 00 00 00 00 00 00 00 00 00 00 00 00 00 00 00 00
00 00 00 00 00 00 00 00 00 00 00 00 00 00 00 00 02 00 00 00 02 02 02 02 02 00 00 00 00 00 00 00
00 00 47 00 00 00 00 00 00 00 00 00 00 00 00 00 00 00 00 00 00 00 00 00 00 00 00 00 00 00 00 00
00 48 44 49 00 00 00 00 00 00 00 00 00 00 00 00 00 47 00 00 00 00 00 00 00 00 00 00 19 18 00 00
48 44 45 46 49 00 00 00 00 00 00 64 65 65 65 66 48 46 49 00 00 00 00 64 65 66 00 00 23 27 00 00
01 01 01 01 01 01 01 01 01 01 01 01 01 01 01 01 01 01 01 01 01 01 01 01 01 01 01 01 01 01 01 01
01 01 01 01 01 01 01 01 01 01 01 01 01 01 01 01 01 01 01 01 01 01 01 01 01 01 01 01 01 01 01 01
