00 00 00 00 00 00 00 00 00 00 00 00 00 00 00 00 00 00 00 00 00 00 00 00 00 00 00 00 00 00 00
00 00 00 00 00 00 00 00 00 00 00 00 00 00 00 00 00 00 00 00 00 00 00 00 00 00 00 00 00 00 00
00 00 00 00 00 00 00 00 00 00 00 00 00 00 00 00 00 00 44 45 46 00 00 00 00 00 00 00 00 00 00
00 00 00 00 00 00 00 44 45 46 00 00 00 00 00 00 00 00 47 48 49 00 00 00 00 00 00 00 00 00 00
00 00 00 00 00 00 00 47 48 49 00 00 00 00 00 00 00 00 00 00 00 00 00 00 00 00 00 00 00 00 00
00 00 00 00 00 00 00 00 00 00 00 00 00 00 00 00 00 00 00 00 00 00 00 00 00 00 00 00 00 00 00
00 00 00 00 00 00 00 00 00 00 00 00 00 00 00 00 00 00 00 00 00 00 00 00 00 00 00 00 00 00 00
00 00 00 00 00 00 00 00 00 00 00 00 00 00 00 00 00 00 00 00 00 00 00 00 00 00 00 00 00 00 00
00 00 00 00 00 00 00 00 00 00 00 00 00 00 00 00 00 00 00 00 00 00 00 00 00 00 00 00 00 00 00
00 00 00 00 00 00 00 00 00 00 00 03 00 03 00 03 00 00 00 00 00 00 00 00 02 00 00 02 00 00 00
00 00 00 00 00 2F 00 00 06 00 00 00 00 00 00 00 00 00 00 00 00 00 00 02 02 00 00 02 02 00 00
00 00 00 00 30 2C 31 00 07 00 00 00 00 00 00 00 00 00 00 00 00 00 02 02 02 00 00 02 02 02 00
00 00 00 30 2C 2D 2E 31 0B 42 00 00 00 00 00 00 00 40 41 42 00 02 02 02 02 41 41 02 02 02 02
01 01 01 04 04 04 04 01 01 01 01 01 01 01 04 04 04 01 01 01 01 01 01 01 01 01 01 01 01 01 01
01 01 01 01 04 04 04 01 01 01 01 01 01 04 04 04 01 01 01 01 01 01 01 01 01 01 01 01 01 01 01
